5 0 0 0 1 0 0 0 0 1 4 0 0 0 0 0 
2 0 1 1 1 1 1 1 0 1 1 1 1 1 1 0 
1 0 0 0 0 0 0 1 0 1 0 0 0 0 0 0 
1 0 1 1 1 1 0 1 0 1 0 1 0 1 1 1 
1 0 1 0 4 1 0 1 0 1 0 1 0 0 0 0 
0 0 1 0 1 1 0 1 0 1 0 1 1 1 1 0 
0 1 1 0 1 0 0 1 0 0 0 0 0 0 1 0 
0 1 0 0 1 0 1 1 1 1 1 1 1 0 1 0 
0 1 0 1 1 0 1 2 0 0 0 0 1 0 1 1 
0 1 0 0 1 1 1 0 0 0 1 0 1 0 0 6 
0 1 1 0 0 0 0 0 2 0 1 0 1 1 1 1 
0 0 0 0 1 1 1 2 4 0 1 0 0 0 0 3 
