0 0 0 0 0 0 0 4 1 6 0 0 0 0 0 0
0 9 0 0 0 0 0 0 1 0 0 0 0 0 0 0 
0 0 0 0 0 1 0 0 1 0 0 0 0 0 0 0 
0 0 0 0 0 1 0 2 1 0 0 0 0 0 0 0 
0 0 0 0 0 1 0 0 1 0 0 0 0 0 0 0 
0 0 0 0 0 1 2 0 1 0 0 0 0 0 0 0 
0 3 0 0 0 1 0 0 1 0 0 0 0 0 0 0 
0 0 0 0 0 1 0 2 1 0 0 0 0 0 0 0 
0 0 3 0 0 1 0 5 1 0 0 0 0 0 0 0 
0 0 0 0 0 1 0 0 1 0 0 0 0 0 0 0 
0 0 0 0 0 1 0 0 0 0 0 0 0 0 0 0 
0 0 0 3 0 1 0 0 0 0 0 0 0 0 0 0 
