1 1 1 1 1 1 1 1 1 1 1 1 1 1 1 1
1 0 0 0 0 0 0 5 0 0 0 0 0 0 0 1
1 0 1 1 1 1 1 0 1 0 0 1 1 1 0 1
1 0 1 0 0 0 1 0 1 1 1 1 2 0 0 1
1 0 1 0 0 0 1 0 1 0 0 4 2 0 1 1
1 0 1 3 0 0 1 0 1 0 0 0 2 0 0 1
1 0 1 1 1 0 0 0 0 0 0 0 2 1 5 1
1 0 0 0 1 2 2 2 2 0 0 1 1 2 2 1
1 1 1 0 0 0 0 0 0 1 0 0 0 0 0 1
1 1 1 1 0 2 2 2 2 2 1 1 1 0 0 1
1 0 0 0 0 0 0 0 0 5 5 5 1 0 6 1
1 1 1 1 1 1 1 1 1 1 1 1 1 1 1 1